"filename", "language", "HTML", "JavaScript", "CSS", "comment", "blank", "total"
"f:\Bahria University On Campus\BSE-4A\DBMS-Lab\Project\DBMS-Project\public\admin.html", "HTML", -1, 0, 0, 1, 0, 0
"f:\Bahria University On Campus\BSE-4A\DBMS-Lab\Project\DBMS-Project\public\css\footer.css", "CSS", 0, 0, 119, 1, 20, 140
"f:\Bahria University On Campus\BSE-4A\DBMS-Lab\Project\DBMS-Project\public\css\user-profile.css", "CSS", 0, 0, 81, 0, 10, 91
"f:\Bahria University On Campus\BSE-4A\DBMS-Lab\Project\DBMS-Project\public\index.html", "HTML", 96, 0, 0, 0, 23, 119
"f:\Bahria University On Campus\BSE-4A\DBMS-Lab\Project\DBMS-Project\public\js\product-details-script.js", "JavaScript", 0, 64, 0, 142, 30, 236
"f:\Bahria University On Campus\BSE-4A\DBMS-Lab\Project\DBMS-Project\public\js\product-listing-script.js", "JavaScript", 0, 61, 0, 126, 26, 213
"f:\Bahria University On Campus\BSE-4A\DBMS-Lab\Project\DBMS-Project\public\product-details.html", "HTML", 0, 0, 0, 0, -30, -30
"f:\Bahria University On Campus\BSE-4A\DBMS-Lab\Project\DBMS-Project\public\purchase-history.html", "HTML", 724, 0, 0, 10, 50, 784
"f:\Bahria University On Campus\BSE-4A\DBMS-Lab\Project\DBMS-Project\public\search.html", "HTML", 81, 0, 0, 16, 14, 111
"Total", "-", 900, 125, 200, 296, 143, 1664