"filename", "language", "JavaScript", "comment", "blank", "total"
"f:\Bahria University On Campus\BSE-4A\DBMS-Lab\Project\DBMS-Project\public\js\admin-script.js", "JavaScript", 136, 10, 12, 158
"f:\Bahria University On Campus\BSE-4A\DBMS-Lab\Project\DBMS-Project\public\js\admin-sign-in-script.js", "JavaScript", 28, 2, 4, 34
"f:\Bahria University On Campus\BSE-4A\DBMS-Lab\Project\DBMS-Project\public\js\cart.js", "JavaScript", 203, 185, 27, 415
"f:\Bahria University On Campus\BSE-4A\DBMS-Lab\Project\DBMS-Project\public\js\hash-password.js", "JavaScript", 10, 0, 2, 12
"f:\Bahria University On Campus\BSE-4A\DBMS-Lab\Project\DBMS-Project\public\js\order-management-script.js", "JavaScript", 8, 3, 2, 13
"f:\Bahria University On Campus\BSE-4A\DBMS-Lab\Project\DBMS-Project\public\js\product-details-script.js", "JavaScript", 86, 13, 15, 114
"f:\Bahria University On Campus\BSE-4A\DBMS-Lab\Project\DBMS-Project\public\js\product-listing-script.js", "JavaScript", 106, 17, 17, 140
"f:\Bahria University On Campus\BSE-4A\DBMS-Lab\Project\DBMS-Project\public\js\script.js", "JavaScript", 64, 12, 16, 92
"f:\Bahria University On Campus\BSE-4A\DBMS-Lab\Project\DBMS-Project\public\js\session-saving.js", "JavaScript", 103, 14, 7, 124
"f:\Bahria University On Campus\BSE-4A\DBMS-Lab\Project\DBMS-Project\public\js\signup-signin.js", "JavaScript", 276, 13, 33, 322
"Total", "-", 1020, 269, 135, 1424